ագրեգացվում	-
ադմինիստրատորի	-
ազատ	free
ազգային	national
ազգերի	-
ազդակները	-
ազդել	-
ազդեցության	-
ազդեցություն	influence
ազդեցությունը	-
ազնավուր	Aznavour
ալգորիթմներ	-
ալգորիթմների	-
ածխաթթու	carbonicacid
ակադեմիա	academy
ակադեմիական	-
ակադեմիայի	-
ակադեմիան	-
ակզ	-
ակտիվ	asset
ակտիվություն	-
ակտիվությունը	-
աղբյուր	source
աղբյուրը	-
աղբյուրներ	-
աղբյուրները	-
աղքատությունը	-
աճ	growth
աճել	grow
աճի	-
աճող	-
ամեն	amen
ամենաառաջին	-
ամենաերկար	-
ամենաթարմ	-
ամենամյա	-
ամենաշատը	-
ամենասկզբում	-
ամերիաբանկը	-
ամերիաբանկում	-
ամերիկացի	American
ամերիկյան	American
ամիս	month
ամիսը	-
ամն	USA
ամսագրերում	-
ամսագրին	-
ամսվա	-
այդ	that
այդուամենայնիվ	-
այդտեղ	there
այժմ	now
այլ	other
այլընտրանքային	alternative
այլոց	-
այլուր	-
այլևս	-
այն	that
այնպես	-
այնպիսի	-
այնքան	so
այս	this
այսպիսով	-
այսօր	today
այցելող	-
այցելության	-
այցելությունը	-
այցելությունների	-
այցելում	-
այցելուների	-
այցերը	-
այցի	-
անանուն	untitled
անափիոսյանը	-
անգամ	time
անգլիացի	English
անդամ	member
անդամակցելով	-
անդամներին	-
անդամներից	-
անդղե	-
անդրադարձանք	-
անդրանիկ	firstborn
անելու	-
անժելա	-
անհամադրելիությանը	-
անհամապատասխանության	-
անհանգստացնող	bothersome
անհապատասխանության	-
անհապատասխանությանն	-
անհապատասխանություն	-
անհատական	-
անհատները	-
անհատների	-
անհատներին	-
անհրաժեշտ	necessary
անհրաժեշտություն	need
անհրաժեշտությունը	-
անհրաժեշտությունն	-
անձնական	-
աննա	Anna
անուղղակի	indirect
անում	-
անունը	-
անունից	-
անպայմանորեն	-
անպարկեշտ	-
անջրպետը	-
անվստահության	-
անվտանգ	safe
անվտանգության	-
անվտանգությունը	-
անտինյան	-
անցավ	-
անցե	-
անցեք	-
անցկացնում	-
անցկացում	-
անցնելու	-
անցում	thoroughfare
անցումային	-
աշակերտների	-
աշխատակիցների	-
աշխատանք	work
աշխատանքային	-
աշխատանքը	-
աշխատանքի	-
աշխատանքն	-
աշխատանքներ	-
աշխատանքներում	-
աշխատաշուկա	labormarket
աշխատաշուկայի	-
աշխատաշուկային	-
աշխատաշուկայում	-
աշխատաշուկան	-
աշխատատեղերը	-
աշխատատեղերի	-
աշխատարանը	-
աշխատարանի	-
աշխատարանն	-
աշխատարանների	-
աշխատացնելու	-
աշխատել	work
աշխատի	-
աշխատող	worker
աշխատողները	-
աշխատողների	-
աշխատուժ	labourpower
աշխատուժի	-
աշխատում	-
աշխարհը	-
աշխարհի	-
աշխարհում	-
աչքերով	-
ապա	-
ապագա	future
ապագայի	-
ապագային	-
ապագայում	-
ապահովելու	-
ապահովելուն	-
ապահովություն	security
ապահովվելու	-
ապանձնավորումը	-
ապհ	CIS
ապրիլի	-
ապրիլին	-
աջակցել	countenance
աջակցման	-
աջակցությամբ	-
աջակցություն	assistance
աջակցում	support
առ	apud
առանձին	separate
առանձնահատկություններին	-
առանձնացրել	-
առանց	without
առաջ	before
առաջանում	-
առաջատար	frontrunner
առաջարկել	offer
առաջարկի	-
առաջարկներ	-
առաջարկություններ	-
առաջարկությունների	-
առաջացել	-
առաջիկա	-
առաջին	first
առաջինը	-
առաջնահերթ	-
առաջնահերթություններին	-
առավելագույնը	-
առկա	available
առմամբ	-
առնել	take
առնելով	-
առնում	-
առնչվող	-
առողջ	healthy
առողջապահության	-
առողջապահություն	healthcare
առումով	-
առջև	-
առցանց	online
առևտրային	-
ասաց	-
ասել	say
ասիայում	-
աստիճանաբար	-
աստիճանի	-
աստիճանով	-
ավագ	senior
ավագանու	-
ավանդական	traditional
ավարտել	end
ավարտելուց	-
ավարտին	-
ավարտում	-
ավարտվեց	-
ավելացող	-
ավելացրեք	-
ավելի	more
ավելին	more
ավելցուկ	-
ավինյան	-
ավինյանը	-
ավինյանի	-
ավտոարդյունաբերության	-
արագ	fast
արագացման	-
արագացմանը	-
արագացնել	accelerate
արագացնելու	-
արայիկ	-
արարողության	-
արբանյակային	-
արբանյակների	-
արգելափակել	immure
արդեն	already
արդյո՞ք	-
արդյունավետ	fruitful
արդյունավետությունը	-
արդյունք	product
արդյունքները	-
արդյունքների	-
արդյունքներին	-
արդյունքում	-
արդյոք	-
արժանապատիվ	-
արժանացել	-
արժեքավոր	-
արհեստական	artificial
արձագանքին	-
արձագանքման	-
արման	-
արմենակ	-
արմենը	-
արմենի	-
արմենիայում	-
արմենին	-
արշավների	-
արտահայտությունները	-
արտանետած	-
արտաքին	outside
արփինե	-
արևելյան	-
արևելքում	-
արևիկ	-
աքսելերատոր	-
աֆրիկայում	-
բազային	-
բազմաթիվ	-
բազմաշահառու	-
բազմապատկել	multiply
բազում	many
բաժանորդագրվել	subscribe
բաժանորդագրվեք	-
բաժինը	-
բաժնի	-
բալդրյան	-
բախվում	-
բակալավրի	-
բաղադրիչ	component
բայց	but
բանականությամբ	-
բանականության	-
բանականություն	intelligence
բանականությունը	-
բանաձևերը	-
բանաձևը	-
բանկը	-
բանկի	-
բանկում	-
բաշխման	-
բավականաչափ	enough
բավարարվածության	-
բարդ	complex
բարդությունն	-
բարեգործական	charitable
բարելավել	improve
բարելավելու	-
բարելավման	-
բարելավում	-
բարելավումը	-
բարեկամների	-
բարեկեցության	-
բարեկեցություն	-
բարերար	-
բարեփոխումների	-
բարի	good
բարիքներից	-
բարձրագույն	-
բարձրացման	-
բարոմետրը	-
բարուզերի	-
բաց	open
բացակայություն	-
բացահայտել	-
բացահայտելու	-
բացահայտմանը	-
բացահայտում	-
բացահայտումը	-
բացառապես	-
բացառությամբ	-
բացառություն	-
բացառում	-
բացասական	minus
բացատրեցինք	-
բացատրեք	-
բացատրում	-
բացի	but
բացումն	-
բելլա	-
բելլան	-
բեյրութի	-
բենջամին	-
բերում	-
բերված	-
բերքահավաքը	-
բերքահավաքի	-
բերքը	-
բերքի	-
բիզնես	business
բիզնեսի	-
բիզնեսների	-
բիզնեսներին	-
բլոգ	blog
բլոքչեյնի	-
բյուջեի	-
բյուջետավորում	-
բյուջետավորումը	-
բյուրոյի	-
բնական	natural
բնակչության	-
բնապահպանական	-
բնապահպանության	-
բնապահպանություն	conservation
բնույթ	nature
բնույթը	-
բնույթի	-
բոթլինգ	-
բոլոր	all
բոլորը	everybody
բոլորի	-
բոննում	-
բովանդակության	-
բովանդակությունը	-
բուժզննման	-
բուժզննում	-
բուժզննումը	-
բուժվելու	-
բրազիլիայում	-
բրաուզերի	-
բրաուզերների	-
բրաուզերում	-
բրատիսլավայում	-
բրիտանացի	-
բրիտանիայի	-
բրյուգեի	-
բրոյթման	-
բրոշյուր	brochure
գ	-
գազի	-
գալուստ	coming
գաղափարը	-
գաղափարի	-
գաղափարներից	-
գաղափարներն	-
գաղտնիության	-
գաղտնիությունը	-
գաստրոտուրիզմը	-
գենդերային	-
գեներացման	-
գեներացնում	-
գերագույն	supreme
գերազանցությամբ	-
գերկրթված	-
գերմանիայի	-
գիտական	scientific
գիտելիքի	-
գիտելիքները	-
գիտելիքների	-
գիտելիքներին	-
գիտելիքներով	-
գիտի	-
գիտության	-
գլխավոր	head
գլխավորությամբ	-
գծանշված	-
գծով	-
գյուղական	country
գյուղատնտեսական	agricultural
գյուղատնտեսները	-
գյուղատնտեսների	-
գյուղատնտեսության	-
գնալ	go
գնալով	-
գնահատել	evaluate
գնահատելու	-
գնահատման	-
գնում	purchase
գոհացուցիչ	-
գոյություն	existence
գովազդներ	-
գործադիր	application
գործազրկության	-
գործակալություններից	-
գործառնական	operational
գործառնության	-
գործառույթի	-
գործառույթներ	-
գործառույթները	-
գործարկել	run
գործել	function
գործելը	-
գործելու	-
գործելուն	-
գործերի	-
գործընթաց	process
գործընթացը	-
գործընթացի	-
գործընթացները	-
գործընթացում	-
գործընկերը	-
գործընկերներ	-
գործընկերները	-
գործընկերների	-
գործընկերներին	-
գործընկերությունների	-
գործի	-
գործիչ	-
գործիք	tool
գործիքը	-
գործիքի	-
գործիքն	-
գործիքներ	-
գործիքները	-
գործողություններ	-
գործողությունների	-
գործողություններից	-
գործոններ	-
գործում	-
գործունեության	-
գործունեությունը	-
գտնել	find
գտնելու	-
գտնվող	-
գտնվում	-
գրանցել	writedown
գրանցելը	-
գրանցման	-
գրանցում	propiska
գրանցվելիս	-
գրառումները	-
գրասենյակ	office
գրասենյակի	-
գրասենյակներ	-
գրասենյակներում	-
գրասենյակում	-
գրեթե	almost
դա	it
դաշնային	federal
դաշնությունը	-
դաշտային	-
դաշտերի	-
դառնալ	become
դասախոսի	-
դասական	classical
դասընթացների	-
դասընթացներին	-
դաստիարակությունը	-
դատական	judicial
դարի	-
դարձե	-
դարձնել	make
դարձնելու	-
դեկտեմբերին	-
դեպի	toward
դեպքերը	-
դեպքերի	-
դեպքերում	-
դեպքում	-
դեռ	yet
դեռեւս	yet
դեսպան	ambassador
դեր	part
դերակատարներ	-
դերակատարների	-
դերը	-
դերն	-
դը	-
դժգոհության	-
դժվար	hard
դիալոգ	-
դիզայն	design
դիզայներներ	-
դիզայնի	-
դիլիջանը	-
դիմել	-
դիվանագետ	diplomat
դիվերսիֆիկացնել	diversify
դիվերսիֆիկացնելու	-
դիտարկել	contemplate
դիտարկենք	-
դիտել	view
դմիտրի	-
դմիտրին	-
դու	you
դուրս	outside
դուք	you
դպրոց	school
դպրոցը	-
դպրոցից	-
դպրոցն	-
դպրոցներ	-
դպրոցներում	-
դրա	-
դրական	-
դրանց	-
դրանցով	-
դրանք	-
դրոնների	-
դրությամբ	-
դրսևորմամբ	-
եզակի	singular
եզրակացությունները	-
եթե	if
ելույթի	-
եկամտի	-
եկան	-
եկեք	-
եղանակի	-
եղանակները	-
եղել	-
եղեք	-
եմ	I'm
են	-
ենթադրությունները	-
ենթադրում	-
ենթադրվում	-
ենթակառուցվածքները	-
ենթատեքստը	-
ենթարկվեն	-
ենք	are
եպհ	-
եռօրյա	triduan
եվրոպական	European
եվրոպայի	-
եվրոպայում	-
երախտագիտություն	gratitude
երաշխավորել	guarantee
երաշխավորում	-
երաշխիքներ	-
երբ	when
երբեք	never
երեխային	-
երեխաների	-
երեխաներին	-
երեւան	Yerevan
երեք	three
երը	-
երի	-
երին	-
երիտասարդ	young
երիտասարդները	-
երիտասարդների	-
երկար	long
երկարաժամկետ	long-term
երկիրը	-
երկու	two
երկուական	binary
երկրի	-
երկրների	-
երկրներից	-
երկրում	-
երրորդ	third
երևան	-
երևանի	-
երևանյան	-
երևույթները	-
եւ	and
եք	-
զարգացման	-
զարգացմանը	-
զարգացնել	improve
զարգացում	development
զարգացումը	-
զբաղեցրել	-
զբաղված	busy
զբաղվածության	-
զբաղվածությունը	-
զբոսաշրջային	-
զբոսաշրջիկի	-
զբոսաշրջիկից	-
զբոսաշրջիկները	-
զբոսաշրջիկների	-
զբոսաշրջությամբ	-
զբոսաշրջության	-
զբոսաշրջությանն	-
զբոսաշրջությունը	-
զբոսաշրջությունն	-
զգայական	-
զգացմունքները	-
զեկույց	report
զեկույցի	-
զեկույցին	-
զեկույցներից	-
զեկուցողները	-
զերծ	-
զիմբաբվե	zimbabwe
զորջ	-
զորջը	-
զրոյական	-
զրուցել	talk
զրուցեցինք	-
զրպարտող	-
է	is
էակներ	-
էգգերը	-
էին	-
էինք	-
էլ	ale
էլեկտրոնային	electronica
էլեն	-
էլիսոն	-
էկոհամակարգին	-
էկոնոմիկայի	-
էկոտուրիզմն	-
էներգայի	-
էներգետիկայի	energy
էներգիայի	-
էջեր	-
էջերում	-
էջին	-
էր	-
էրեբունի	Erebuni
էքսպոներ	-
ը	-
ընդգծեց	-
ընդլայնել	-
ընդհանուր	common
ընդունել	take
ընդունված	-
ընթացքում	during
ընկալելու	-
ընկած	-
ընկերությունը	-
ընկերություններ	-
ընկերություններին	-
ընկերությունում	-
ընկղմվել	-
ընտրանքի	-
ընտրել	choose
ընտրելու	-
ընտրություն	election
ընտրություններ	voting
ընտրությունների	-
ընտրում	selection
ըստ	according
թ	-
թագավորության	-
թանգարանների	-
թարմացումն	-
թարմացվող	-
թափուր	vacant
թե	-
թեմաների	-
թեմաներն	-
թեմաներով	-
թեստավորում	-
թեստավորումը	-
թերագնահատում	-
թերթիկներ	-
թերկրթվածները	-
թիմը	-
թիմի	-
թիմին	thymine
թիմն	-
թիվը	-
թիրախների	-
թղթի	-
թյուրիմացաբար	-
թույլ	weak
թույլտվությունը	-
թռիչքաձև	-
թվային	digital
թվայնացված	-
թվերով	-
թվով	-
թվում	-
ժամանակ	time
ժամանակահատվածում	-
ժամանակավոր	-
ժամանակը	-
ժամանակն	-
ժամանակում	-
ժամերը	-
ժինաղին	-
ժյուրիին	-
ժնևի	-
ժողովրդի	-
ժոնգնան	-
ի	-
ի՞նչ	what
իհարկե	certainly
իմփաքթ	-
ին	-
ինչ	what
ինչը	-
ինչի	-
ինչն	-
ինչո՞ւ	-
ինչպե՞ս	-
ինչպես	how
ինչպիսիք	-
ինչքա՞ն	-
ինչքան	-
ինստիտուտի	-
ինստիտուտին	-
ինստիտուտներ	-
ինտեգրում	-
ինտեգրված	-
ինտերակտիվ	interactive
ինքնությունն	-
իռացիոնալ	irrational
իռլանդիայի	-
իսկ	and
իտալիայի	-
իր	thing
իրագործման	-
իրադարձությունների	-
իրադարձություններին	-
իրազեկման	-
իրազեկվածության	-
իրական	true
իրականացման	-
իրականացմանը	-
իրականացնել	-
իրականացնելու	-
իրականացնում	-
իրականացումը	-
իրականացումն	-
իրականացված	-
իրականացվող	-
իրականացվում	-
իրականացրել	-
իրականության	-
իրականություն	reality
իրականում	infact
իրականցումը	-
իրապես	-
իրավաբանի	-
իրավաբանության	-
իրավագիտության	-
իրավական	legal
իրավիճակի	-
իրավիճակն	-
իրավունք	right
իրավունքի	-
իրավունքները	-
իրավունքների	-
իրատեսական	-
իրենց	-
լաբ	-
լաբերը	-
լաբերի	-
լաբի	-
լաբորատորիալ	-
լայն	wide
լայնածավալ	ample
լավ	good
լավագույն	best
լավացնելու	-
լեգիտիմ	-
լիարժեք	-
լինեին	-
լինել	be
լինելով	-
լինելու	-
լիովին	fully
լոգոները	-
լոկացիան	-
լոնդոնի	London
լուիզ	-
լուիզը	-
լուծել	solve
լուծելու	-
լուծող	-
լուծում	solution
լուծումներ	-
լուծումները	-
լուծումների	-
լուծումներով	-
լրատվական	-
լրատվամիջոցներ	-
լրացնել	fill
լրացուցիչ	additional
խաթարող	-
խախտման	-
խախտում	violation
խաղաղություն	peace
խաղացող	player
խառնուրդ	medley
խարվալ	-
խելամիտ	-
խթանելու	-
խթանները	-
խթանում	-
խմբակցությունից	-
խմբի	-
խնայել	-
խնայելը	-
խնդիրը	-
խնդիրներ	object
խնդիրները	-
խնդիրներից	-
խնդրել	request
խնդրելու	-
խնդրի	-
խնդրին	-
խնդրում	-
խոշոր	large
խոչընդոտներն	-
խոչընդոտող	-
խոսեցինք	-
խոստումը	-
խոսքը	-
խոսքով	-
խոսքում	-
խորապես	-
խորը	-
խորհուրդ	soviet
խորհուրդը	-
խորհուրդներին	-
խորհրդատու	advisor
խորհրդատուի	-
խորհրդատվական	-
խորհրդատվություն	counsel
խորհրդի	-
խորհրդին	-
խորհրդում	-
խորքային	background
խոցելի	vulnerable
խումբ	group
խուսափելու	-
խրախուսել	encourage
խրոնիկական	chronic
ծախսատար	-
ծախսելն	-
ծախսերը	-
ծախսերի	-
ծայրերում	-
ծանոթանալ	-
ծանոթանալու	-
ծանոթացե	-
ծանոթացեք	-
ծառայել	serve
ծառայող	-
ծառայողները	-
ծառայողների	-
ծառայողներին	-
ծառայության	-
ծառայությանը	-
ծառայությունները	-
ծառայությունների	-
ծառայություններն	-
ծառայություններում	-
ծավալները	-
ծիանսի	-
ծնվել	beborn
ծրագեր	-
ծրագիր	program
ծրագիրը	-
ծրագիրն	-
ծրագրավորողներ	-
ծրագրեր	-
ծրագրերը	-
ծրագրերի	-
ծրագրի	-
ծրագրում	-
կա	thereis
կադրեր	-
կադրերի	-
կազդի	-
կազմակերպելու	-
կազմակերպության	-
կազմակերպություն	organization
կազմակերպությունը	-
կազմակերպություններ	-
կազմակերպությունների	-
կազմակերպություններին	-
կազմել	make
կազմող	bookbinding
կազմում	-
կամ	or
կամավոր	volunteer
կամավորական	-
կամրջել	-
կամրջելով	-
կայացման	-
կայացնել	-
կայացնելու	-
կայացնում	-
կայացող	-
կայացրած	-
կայուն	stable
կայք	website
կայքերի	-
կայքերն	-
կայքը	-
կայքի	-
կայքից	-
կայքն	-
կայքում	-
կան	thereare
կանգնելով	-
կանզասի	-
կանխատեսելի	predictable
կանխատեսելու	-
կանխարգելիչ	-
կանխել	-
կանոնակարգի	-
կանտոն	canton
կանտոնում	-
կաշխատի	-
կապ	preposition
կապելով	-
կապեր	linkage
կապերի	-
կապված	-
կաջակցեն	-
կառավարելը	-
կառավարելու	-
կառավարման	-
կառավարության	-
կառավարությանը	-
կառավարություն	government
կառավարությունը	-
կառավարությունից	-
կառավարություններ	-
կառավարությունների	-
կառավարությունում	-
կառավարում	direction
կառներ	-
կառույցներ	-
կառույցներին	-
կառուցելու	-
կառուցվել	-
կավելանա	-
կատարել	perform
կատարելագործելու	-
կատարելագործում	-
կատարյալ	perfect
կատարողական	-
կատարողականը	-
կատարում	-
կատարումը	-
կատարումն	-
կարագացնեն	-
կարգավորման	-
կարգավորումները	-
կարգավորումներով	-
կարդալ	read
կարելի	-
կարիերա	career
կարիերայի	-
կարիերան	-
կարին	erzurum
կարիք	want
կարիքը	-
կարիքն	-
կարիքները	-
կարիքներին	-
կարծիքը	-
կարծիքներ	-
կարծիքները	-
կարծրատիպային	-
կարճ	short
կարող	able
կարողանանք	-
կարողանում	-
կարողացել	-
կարողությունները	-
կարողությունների	-
կարևոր	-
կարևորությունը	-
կարևորում	-
կբացատրի	-
կգործի	-
կգրանցվի	-
կդառնան	-
կեղծիքը	-
կենտրոն	center
կենտրոնական	central
կենտրոնացնում	-
կենտրոնացրինք	-
կենտրոնը	-
կենտրոնի	-
կենտրոնին	-
կենտրոնն	-
կենտրոնների	-
կենտրոնում	-
կեսն	-
կերպ	mode
կզարգացնեն	-
կզն	-
կթարմացվեն	-
կիսվել	-
կիսվեց	-
կիսվեցինք	-
կիսվի	-
կիսվում	-
կիրականացվեն	-
կիրականացվի	-
կիրառական	-
կիրառել	apply
կիրառելի	-
կիրառելով	-
կիրառելու	-
կիրառմամբ	-
կիրառման	-
կիրառումը	-
կիրառումից	-
կիրառվող	-
կիրառվում	-
կլիմայական	-
կլիմայի	-
կլինի	-
կծանոթանան	-
կծառայի	-
կկատարի	willpeform
կկարողանանանք	-
կկիրառենք	-
կհամագործակցեն	-
կհամալրենք	-
կհամապատասխանի	-
կհամարվի	-
կհաջողի	-
կմշակեն	-
կյանքի	-
կյանքում	-
կներկայացվեն	-
կնպաստեն	-
կնպաստի	-
կնքել	seal
կնքում	-
կշարունակենք	-
կշարունակի	-
կոլբա	-
կոլորադոյի	-
կողմերը	-
կողմերի	-
կողմից	atthehandsof
կոմերցիոն	-
կոմիտե	committee
կոմիտեում	-
կոնտակտներ	Contacts
կոչ	call
կոչել	name
կոչում	vocation
կոչումով	-
կովկասում	-
կորստի	-
կունենա	-
կուսակցության	-
կուտակում	-
կպահենք	-
կպահպանենք	-
կպատասխանենք	-
կջնջենք	-
կստեղծեն	-
կստեղծվեն	-
կստուգի	-
կվավերացվեն	-
կտա	-
կտան	-
կտեղեկացնենք	-
կտրամադրեն	-
կտրամադրվեն	-
կտրվածքով	-
կրթաթոշակ	scholarship
կրթական	-
կրթության	-
կրթություն	education
կրթությունը	-
կրթությունից	-
կրթությունն	-
կրթված	-
կրիչի	-
կրկնօրինակվելու	-
կրճատել	-
կրճատմանը	-
կրող	-
կրում	-
կցե	-
կփոխանցվի	-
կփոփոխվի	-
կօգնեն	-
կօգնի	-
կօգտագործեն	-
կօգտագործենք	-
կօգտագործվի	-
կօգտվեն	-
հաբ	pill
հակառակը	-
հաղթահարել	-
հաղթահարելու	-
հաղթող	winner
հաղորդակցելու	-
հաղորդակցության	-
հաղորդակցություն	communication
հաճախ	often
հաճախակի	frequent
հաճույք	pleasure
համագործակցել	cooperate
համագործակցելով	-
համագործակցությամբ	-
համագործակցության	-
համագործակցությանը	-
համագործակցություն	cooperation
համագործակցությունը	-
համագործակցություններից	-
համագործակցում	partnership
համալիր	-
համալսարան	university
համալսարանական	-
համալսարանը	-
համալսարանի	-
համալսարանից	-
համալսարաններում	-
համալսարանում	-
համակարգ	system
համակարգային	systematic
համակարգեր	-
համակարգի	-
համակարգն	-
համակարգող	-
համակարգում	-
համակարգչային	-
համակարգչի	-
համակարծիք	-
համահիմնադիր	-
համահունչ	-
համաձայն	accordingto
համաձայնության	-
համաձայնություն	consensus
համաձայնությունը	-
համաձայնությունից	-
համաձայնությունն	-
համաձայնվեք	-
համաձայնվում	-
համայնքային	-
համայնքին	-
համանախագահ	-
համանախագահներ	-
համաշխարհային	-
համապատասխան	accordingto
համապատասխանեցնել	-
համապատասխանում	-
համատեղ	-
համատեքստը	-
համատեքստում	-
համար	for
համարժեք	equivalent
համարվում	-
համեմատաբար	-
համոզում	-
համոզված	-
համոզվեք	-
հայ	Armenian
հայաստան	armenia
հայաստանը	-
հայաստանի	Armenia
հայաստանին	-
հայաստանյան	-
հայաստանում	-
հայացքից	-
հայկական	Armenian
հայոց	Armenian
հայտարարությունների	-
հայտնաբերել	discover
հայտնաբերելու	-
հայտնաբերում	-
հայտնի	famous
հայտնվում	-
հանգամանքը	-
հանգույց	knot
հանգույցի	-
հանդես	magazine
հանդիպեց	-
հանդիպման	-
հանդիպումից	-
հանդիպումներ	-
հանդիպումների	-
հանդիսանում	-
հանդիսացող	-
հանձն	-
հանձնաժողովը	-
հանձնակատարի	-
հանձնառության	-
հանձնառություններ	-
հանձնառությունների	-
հանձնառություններով	-
հանձնարարական	-
հանուն	inthenameof
հանրային	-
հանրությանը	-
հանրօգուտ	-
հաշվարկներին	-
հաշվարկում	-
հաշվի	-
հաուի	-
հաջող	lucky
հաջողության	-
հաջողված	-
հաջորդ	following
հասանելի	-
հասարակական	-
հասարակության	-
հասարակություն	society
հասել	-
հասկանալ	understand
հասկանալու	-
հասկանանք	-
հասկացանք	-
հասնելու	-
հաստատ	-
հաստատեց	-
հաստատեք	-
հաստատման	-
հաստատմանը	-
հաստատություններին	-
հաստիք	-
հաստիքներին	-
հասցե	address
հասցեն	-
հասցրել	-
հավանաբար	-
հավանական	-
հավանականությունը	-
հավասարության	-
հավատարմատար	attorney
հավատում	-
հավաքագրած	-
հավաքագրել	-
հավաքագրման	-
հավաքագրումը	-
հավաքել	gather
հավաքելով	-
հավաքելու	-
հավաքում	-
հավաքված	-
հավաքվել	assemble
հավելել	add
հավելեց	-
հավելյալ	-
հատկապես	chiefly
հատուկ	special
հատվածը	-
հատվածի	-
հատվածներ	-
հատվածների	-
հատվածներում	-
հարաբերությունների	-
հարավային	southern
հարարեում	-
հարգի	-
հարթակ	platform
հարթակը	-
հարթակի	-
հարթակներ	-
հարթակներից	-
հարթել	-
հարթում	antialiasing
հարկ	storey
հարկահանության	-
հարկահանությանը	-
հարկահանությունից	-
հարկահավաքության	-
հարկային	-
հարկավոր	necessary
հարկատուներին	-
հարությունյանը	-
հարց	question
հարցեր	-
հարցերը	-
հարցերի	-
հարցերով	-
հարցը	-
հարցին	-
հարցնել	ask
հարցում	request
հարցումներ	-
հարցումներից	-
հարևանների	-
հբըմ	-
հելլենիկ	-
հեղինակությանը	-
հենվել	lean
հենվում	-
հենրիկ	Henry
հենրիկն	-
հենց	very
հեռախոս	telephone
հեռակառավարման	-
հետ	with
հետագա	-
հետագայում	-
հետադարձ	-
հետադարձելի	-
հետազոտական	-
հետազոտել	research
հետազոտող	boffin
հետազոտության	-
հետազոտություն	research
հետազոտություններ	-
հետազոտությունների	-
հետապնդումն	-
հետաքրքրության	-
հետաքրքրությունները	-
հետաքրքրված	-
հետո	after
հետքերով	-
հետևանքները	-
հետևել	-
հետևեց	-
հետևեք	-
հետևյալ	-
հետևում	-
հիասթափեցնող	-
հիման	-
հիմնադիր	founder
հիմնադիրներ	-
հիմնադրամ	foundation
հիմնադրամը	-
հիմնադրամի	-
հիմնադրամների	-
հիմնադրամում	-
հիմնադրեցին	-
հիմնախնդիրները	-
հիմնական	basic
հիմնականում	mostly
հիմնավորում	stemming
հիմնել	found
հիմնված	-
հիմնվելով	-
հիմք	base
հիմքը	-
հիմքով	-
հիմքում	-
հին	old
հինգ	five
հիշատակում	-
հիպոթետիկ	-
հկ	-
հհ	RA
հղումներով	-
հղումով	-
հմուտ	masterly
հմտությունների	-
հմտություններով	-
հյուսիսային	north
հյուրանոցների	-
հնարավոր	possible
հնարավորություն	chance
հնարավորությունը	-
հնարավորություններ	-
հնարավորությունները	-
հնարավորությունների	-
հնգամյա	-
հնչեցվող	-
հնչում	-
հոգ	-
հոգաբարձուների	-
հոգեբանական	psychological
հոգեբանության	-
հոդվածի	-
հոկտեմբերի	-
հողի	earth
հողում	-
հոջին	-
հոսթինգը	-
հովհաննես	John
հույս	hope
հունիսին	-
հունվարից	-
հուշագիր	memorandum
հուշագիրը	-
հուշագրի	-
հուսալիորեն	-
հուսով	-
հռետորաբանության	-
հստակ	serene
հստակորեն	-
հրաժարումումից	-
հրաժարվել	abnegate
հրապարակելու	-
հրապարակումներ	-
ձախողվել	blowupinone'sface
ձգտում	-
ձեզ	you
ձեռնարկատիրական	-
ձեռնարկել	-
ձեռներեց	entrepreneur
ձեռներեցության	-
ձեռք	hand
ձեր	your
ձևավորել	-
ձևավորմանը	-
ձևավորումը	-
ղազարյանը	-
ղեկավար	head
ղեկավարի	-
ղեկավարն	-
ղեկավարությանը	-
ղեկավարում	direction
ճամփորդության	-
ճանաչողական	-
ճանաչված	-
ճանապարհ	road
ճանապարհորդական	-
ճանապարհորդների	-
ճանապարհորդության	-
ճգնաժամերի	-
ճկուն	flexible
ճկունության	-
ճոպանուղին	-
ճորոխյան	-
ճորոխյանը	-
ճորոխյանի	-
մագիստրոսի	-
մազծ	UNDP
մաթեմատիկական	mathematical
մաթեմատիկայի	-
մաժինյան	-
մալմոյի	-
մակ	UnitedNations
մակարդակին	-
մակարդակում	-
մայիսի	-
մանկական	-
մանրամասներ	-
մանրամասները	-
մանրամասներին	-
մաս	part
մասը	-
մասին	about
մասն	-
մասնագետ	-
մասնագետներ	-
մասնագետների	-
մասնագետներին	-
մասնագիտական	-
մասնագիտության	-
մասնագիտություն	profession
մասնագիտությունը	-
մասնագիտություններ	-
մասնագիտությունները	-
մասնագիտությունների	-
մասնակիցներ	-
մասնակիցները	-
մասնակցային	-
մասնակցել	pursue
մասնակցեցին	-
մասնավոր	personal
մատակարարման	-
մատնանշելով	-
մարգարյանը	-
մարգարյանն	-
մարդ	man
մարդակենտրոն	-
մարդասիրական	-
մարդիկ	people
մարդկային	human
մարդկանց	-
մարդու	-
մարիյասին	-
մարիյասինը	-
մարմինների	-
մարմիններին	-
մարմնի	-
մարտահրավերներ	-
մարտահրավերները	-
մարտահրավերների	-
մարտին	Martin
մարտիրոսյան	Martirosyan
մարքեթինգային	-
մարքեթինգի	-
մեզ	urine
մեթոդաբանությամբ	-
մեթոդաբանության	-
մեթոդաբանություններ	-
մեթոդներ	-
մեթոդների	-
մեթոդներից	-
մեթոդներն	-
մեխանիզմով	-
մեծ	great
մեծանում	-
մեծապես	extensively
մեծացնել	grow
մեծացնում	-
մեկ	one
մեկամյա	-
մեկը	someone
մեկի	-
մեկն	-
մեկնարկեց	-
մեկում	-
մենեջմենթի	-
մենջեր	-
մենք	we
մեջ	in
մեր	our
մերի	-
մերձավոր	-
մեքենայական	-
մեքնենաների	-
մի	one
միախառնման	-
միայն	only
միանալ	join
միանալը	-
միանալն	-
միանում	-
միավորել	unite
միավորելով	-
միավորների	-
միավորում	union
միավորված	-
միացե	-
միացել	-
միացյալ	-
միացումը	-
միգուցե	maybe
միլիոն	million
միմյանց	eachother
միմյանցից	-
մինիմիզացումը	-
մինչ	-
մինչդեռ	whereas
մինչև	-
միշտ	always
միջազգային	international
միջամտության	-
միջամտություն	-
միջամտություններ	-
միջամտությունները	-
միջամտությունների	-
միջավայրի	-
միջգործառութային	-
միջոլորտային	-
միջոցառման	-
միջոցառմանը	-
միջոցառումներին	-
միջոցառումներով	-
միջոցները	-
միջոցներին	-
միջոցով	-
միջև	-
միտումը	-
միտումները	-
միտումների	-
միտումներին	-
միտված	-
միրյանա	-
մյուս	other
մյուսները	-
մնացեք	-
մնում	-
մշակաբույսերի	-
մշակել	-
մշակելիս	-
մշակելու	-
մշակման	-
մշակմանը	-
մշակողը	-
մշակողի	-
մշակողների	-
մշակողներին	-
մշակութային	cultural
մշակում	-
մշակույթ	culture
մշակույթը	-
մշակույթի	-
մշակված	-
մշակվել	-
մշտադիտարկել	-
մշտադիտարկման	-
մշտադիտրակման	-
մշտական	constant
մշտապես	-
մոբիլիզացնել	-
մոբիլիզացում	-
մոդել	model
մոդելավորման	-
մոդելը	-
մոդելներ	-
մոլորակը	-
մոնիթորինգի	-
մոնիտորինգի	-
մոսկվայի	-
մովսիսյան	-
մովսիսյանը	-
մոտ	near
մոտավոր	approximate
մոտենալ	approach
մոտեցման	-
մոտեցում	-
մոտեցումը	-
մոտեցումներ	-
մոտեցումների	-
մոտեցումներով	-
մուտք	entrance
մտադրությունների	-
մտածել	think
մտածելու	-
մտածողությունը	-
մտածողությունից	-
մտավոր	cerebral
մրցանակը	-
յորքի	-
յորքում	-
յունիսեֆ	-
յուրաքանչյուր	each
յուրաքանչյուրում	-
ն	-
նա	he
նաիրա	-
նախ	first
նախագիծը	-
նախագիծն	-
նախագծեր	-
նախագծերը	-
նախագծերի	-
նախագծերից	-
նախագծերում	-
նախագծի	-
նախագծից	-
նախազգուշական	-
նախաձեռնությունը	-
նախաձեռնությունն	-
նախաձեռնությունները	-
նախաձեռնություններին	-
նախապատրաստմանը	-
նախասիրությունները	-
նախասիրություններին	-
նախարար	minister
նախարարի	-
նախարարություն	ministry
նախընտրություններն	-
նախընտրում	-
նախկին	-
նախկինում	-
նախնական	preliminary
նախորդ	-
նահանգի	-
նահանգում	-
նամակների	-
նամակներին	-
նայիրի	-
նապատակի	-
նաջերի	-
նաև	-
նեյրոգիտության	-
նեյրոնագիտության	-
ներակայացնում	-
ներակայումս	-
ներառական	-
ներառելու	-
ներառյալ	-
ներառում	-
ներառված	-
ներբեռնել	download
ներբեռնելու	-
ներգործում	-
ներգրաված	-
ներգրավածություն	-
ներգրավածությունը	-
ներգրավել	-
ներգրավվածություն	-
ներգրավվման	-
ներդրող	investor
ներդրում	investment
ներդրումային	-
ներդրումը	-
ներդրումներ	-
ներդրումների	-
ներկայացնել	introduce
ներկայացնում	-
ներկայացուցիչ	representative
ներկայացուցիչները	-
ներկայացված	-
ներկայացրեց	-
ներկայացրինք	-
ներկայումս	currently
ներմուծում	import
ներուժ	-
ներուժը	-
ներսում	-
ներքո	under
ներքևում	-
նիստը	-
նիստի	-
նկատել	-
նկարներով	-
նման	similar
նմանատիպ	-
նյու	nude
նյութ	material
նյութական	material
նյութեր	-
նյութերն	-
նշանակալի	-
նշանակվելը	-
նշել	name
նշեց	-
նշեցինք	-
նշում	mark
նոյեմբերին	-
նոու	-
նոր	new
նորարական	-
նորարարական	-
նորարարարական	-
նորարարներ	-
նորարարների	-
նորարարության	-
նորարարություն	innovation
նորարարությունը	-
նորարարությունն	-
նորարարությունների	-
նորմալ	normal
նորություններ	news
նորությունները	-
նորությունների	-
նորություններին	-
նույն	same
նույնիսկ	even
նպաստ	benefit
նպաստելով	-
նպաստում	-
նպատակ	goal
նպատակադրվել	-
նպատակը	-
նպատակի	-
նպատակն	-
նպատակները	-
նպատակների	-
նպատակներին	-
նպատակներից	-
նպատակներն	-
նպատակով	-
նստավայրում	-
նվազեցնել	reduce
նրա	his
նրանց	them
նրանք	they
նրբությունները	-
շաբաթ	Saturday
շահագործող	user
շահագործումը	-
շահագործվում	-
շահագրգիռ	-
շահառուների	-
շահել	-
շահերի	-
շահի	-
շատ	much
շատերի	-
շարժիչ	engine
շարունակ	always
շարունակական	-
շարունակել	continue
շարունակելով	-
շարունակում	-
շարփ	-
շարփը	-
շարփի	-
շարփն	-
շարք	row
շարքը	-
շղթայի	-
շնորհանդեսը	-
շնորհիվ	-
շնորհվում	-
շոմբի	-
շոշափելի	-
շորճեան	-
շուկան	-
շուկաներում	-
շուտով	soon
շուրջ	about
շվեդիայի	-
շվեյցարիայի	-
շվեյցարիայում	-
շվեցարական	-
շրջանակ	framework
շրջանակը	-
շրջանակում	-
շրջանավարտն	-
շրջանի	-
շրջանում	-
ո՞վ	-
ո՞րն	-
ոգեշնչման	-
ոգին	-
ոգով	-
ոլորտը	-
ոլորտի	-
ոլորտն	-
ոլորտներ	-
ոլորտների	-
ոլորտներից	-
ոլորտներում	-
ոլորտում	-
ողջ	alive
ողջույնի	-
ոչ	no
ով	who
ովքեր	-
որ	which
որակավորում	-
որակավորումներին	-
որակյալ	-
որդեգրած	-
որը	which
որի	-
որին	-
որից	-
որն	-
որո՞նք	-
որոնց	-
որոնք	-
որոշ	some
որոշակի	-
որոշելուն	-
որոշեցինք	-
որոշեք	-
որոշումներ	-
որոշումները	-
որոշումների	-
որպես	-
որպեսզի	that
որտեղ	where
որքան	how
որևէ	-
ու	and
ու՞ր	-
ուդումյանը	-
ուժ	force
ուժային	-
ուժեղ	strong
ուժը	-
ուղարկել	send
ուղարկելու	-
ուղեկցվեց	-
ուղի	track
ուղիղ	directly
ուղին	-
ուղղակի	just
ուղղորդում	-
ուղղությամբ	-
ուղղություններով	-
ուղղվածությամբ	-
ում	whom
ունակ	able
ունակությունները	-
ունակությունների	-
ունեն	-
ունենալ	have
ունենալով	-
ունենալու	-
ունենան	-
ունենք	-
ունեցավ	-
ունեցել	-
ունեցող	-
ունեք	-
ունի	-
ուշադրություն	attention
ուսանողներ	-
ուսանողների	-
ուսանողներին	-
ուսումնասիրել	study
ուսումնասիրությունը	-
ուսումնասիրությունները	-
ուսումնասիրությունների	-
ուսուցանող	-
ուսուցման	-
ուրիշ	other
ուրիշներին	-
ուփսալայի	-
ոքի	-
չաշխատել	-
չարաշահումը	-
չափազանց	excessively
չափում	measurement
չափումներ	measurement
չափումների	-
չբացահայտված	-
չգալ	-
չեն	-
չենք	-
չեք	Czech
չէ	no
չէինք	-
չթողնել	-
չթողնելով	-
չի	-
չիլդրեն	-
չինաստանի	-
չիքը	-
չկա՞	-
չնայած	although
չորս	four
չորսը	-
չունեն	-
չունենալու	-
չունի	-
չպահանջելով	-
չտվող	-
չօգտվել	-
պակաս	lack
պահանջարկի	-
պահանջել	require
պահանջները	-
պահանջներին	-
պահանջում	-
պահանջված	-
պահաջնվի	-
պահել	keep
պահի	-
պահին	-
պահում	-
պահպանումը	-
պահպանվելու	-
պայմանագիր	contract
պայմանավորվածությունների	-
պայմաններ	-
պայմանները	-
պայմանների	-
պայմաններին	-
պայմաններով	-
պայմաններում	-
պայքարը	-
պանելային	-
պաշտոնակատար	-
պաշտոնը	-
պաշտոնյաներին	-
պաշտպանել	protect
պաշտպանելու	-
պաշտպանող	-
պաշտպանության	-
պաշտպանությունը	-
պաշտպանված	-
պատասխան	response
պատասխանատու	liability
պատասխանատվություն	responsibility
պատասխանը	-
պատկանում	-
պատկերացնում	-
պատկերացումը	-
պատկերացումներ	-
պատկերի	-
պատճառն	-
պատճառները	-
պատճառով	after
պատճառված	-
պատմել	narrate
պատմեց	-
պատմությանը	-
պատմություններն	-
պատրաստակամ	-
պատրաստելու	-
պատրաստի	-
պատրաստված	-
պատրաստվել	prepare
պատրաստվելու	-
պարագայում	-
պարբերաբար	periodically
պարզապես	-
պարոն	mister
պարունակում	-
պարտավորությունների	-
պարտատոմսեր	-
պես	-
պետական	-
պետականակերտումը	-
պետությունները	-
պետք	requirement
պիլոտային	-
պիլոտների	-
պլազա	-
պլանը	-
պոտենցիալ	-
պորտֆելի	-
պորտֆոլիո	-
պրակտիկա	-
պրոֆեսոր	professor
ջանքերը	-
ջատագովների	-
ջուդիթ	-
ջրի	-
ռադիո	radio
ռազմավարական	strategic
ռազմավարություն	strategy
ռազմավարությունը	-
ռացիոնալ	rational
ռդ	RussianFederation
ռեալ	-
ռեգիստր	-
ռեսուրսները	-
ռեստորանների	-
ռիսկի	-
ռոտացիոն	-
ռուբեն	Reuben
ռուզաննա	-
ռուս	Russian
ռուսական	Russian
ռուսաստանի	-
ռուսաստանյան	-
ռուսաստանում	-
սա	this
սակայն	yet
սահմանափակող	-
սահմանափակվում	-
սահմաններից	-
սահմաններում	-
սահրադյան	-
սայոն	-
սայոնի	-
սարգսյան	Sargsyan
սարքի	-
սենյակ	room
սեպտեմբերին	-
սեպտեմբերից	-
սերգոյան	-
սերժ	Sergius
սերմերը	-
սերնդի	-
սեփական	-
սեփականատերերին	-
սեփականության	-
սիերայի	-
սիսեռեանը	-
սիսեռյան	-
սիրով	-
սլովակիայում	-
սխալվելու	-
սկզբունք	principle
սկզբունքները	-
սկսած	since
սկսել	start
սկսեցինք	-
սկսում	-
սովորաբար	usually
սովորել	learn
սովորեցինք	-
սովորություններն	-
սովորույթներին	-
սորբոնի	-
սոցիալ	-
սոցիալական	-
սոցիոլոգիայի	-
սպառման	-
սպառողի	-
սպասելու	-
սպը	LLC
սպոլյարիչ	-
սպորտի	-
ստադնարտ	-
ստանալ	receive
ստանալով	-
ստանանք	-
ստանդարտ	standard
ստանդարտներից	-
ստանձնել	-
ստանձնելու	-
ստանձնեց	-
ստանձնում	-
ստանում	-
ստարտափերը	-
ստացել	-
ստացվող	-
ստեղծել	create
ստեղծելով	-
ստեղծելու	-
ստեղծման	-
ստեղծում	generation
ստեղծվել	-
ստեփան	Stephen
ստորագրեց	-
ստորագրման	-
ստորագրված	-
ստորև	-
ստուգել	check
ստուգելով	-
ստուգեք	-
սփյուռքը	-
սփյուռքի	-
սևանում	-
վ	-
վագների	-
վալե	-
վալեի	-
վահան	shield
վահանն	-
վաղ	early
վայրը	-
վանական	monk
վասիլյան	-
վարագ	-
վարդանյան	-
վարդանյանը	-
վարդանյանն	-
վարեցին	-
վարկավորման	-
վարչական	-
վարքաբան	-
վարքաբանական	-
վարքաբանության	-
վարքաբանությունը	-
վարքաբանությունից	-
վարքաբանությունն	-
վարքագիծը	-
վարքագիծն	-
վարքագծային	-
վարքագծի	-
վարքագծին	-
վարքը	-
վարքի	-
վեբ	web
վենետիկի	-
վենչուրային	-
վերաբերյալ	on
վերածել	-
վերածնունդ	rebirth
վերակազմակերպումն	-
վերականգնվող	-
վերահսկել	-
վերահսկող	-
վերահսկվում	-
վերամարքեթինգի	-
վերանայելու	-
վերաորակավորման	-
վերապատրաստման	in-service
վերապրածների	-
վերացնելու	-
վերափոխել	-
վերափոխում	-
վերբեռնել	upload
վերլուծաբան	-
վերլուծական	analytic
վերլուծել	analyze
վերլուծելով	-
վերլուծության	-
վերլուծություն	analysis
վերլուծությունները	-
վերլուծում	-
վերլուծվող	-
վերջին	last
վերջիններից	-
վերջնանպատակն	-
վերջում	last
վեց	six
վիզուալ	-
վիզուալացումը	-
վիզուալիզացնել	-
վիճակագրական	-
վիճակագրության	-
վիրուսից	-
վիրուսներ	virus
վիրուսներից	-
վճարումը	-
վնասի	-
վնասող	-
վստահում	-
վտանգավոր	dangerous
վրա	on
տ	-
տաթևի	-
տալ	give
տալիս	-
տալով	-
տալու	-
տաղանդներ	-
տանել	carry
տանզանիայում	-
տանում	-
տարածաշրջանային	regional
տարածաշրջանից	-
տարածաշրջանում	-
տարածել	-
տարածելու	-
տարածողներից	-
տարածում	distribution
տարբեր	different
տարբերակը	-
տարբերություն	difference
տարբերությունը	-
տարբերվում	-
տարեկան	rye
տարեվերջին	-
տարի	year
տարիներին	-
տարվա	-
տեխնիկապես	-
տեխնոլոգիական	-
տեխնոլոգիաները	-
տեխնոլոգիաների	-
տեխնոպոլ	-
տեղադրելու	-
տեղադրված	located
տեղադրվում	-
տեղակալ	-
տեղական	local
տեղաշարժվելու	-
տեղեկատվական	-
տեղեկատվության	-
տեղեկատվություն	information
տեղեկատվությունը	-
տեղեկացեք	-
տեղեկացված	-
տեղեկությամբ	-
տեղեկության	-
տեղեկություն	information
տեղեկությունը	-
տեղեկություններ	-
տեղեկությունների	-
տեղեկվություն	-
տեղեությունները	-
տեղի	-
տեղյակ	intheknow
տեղում	-
տեսակը	-
տեսակի	-
տեսակները	-
տեսանկյունից	-
տեսլականը	-
տեսլականն	-
տեքստային	-
տիգրան	Tigran
տիկին	madam
տիրապետում	-
տնտեսագետ	economist
տնտեսագետի	-
տնտեսագիտության	-
տնտեսական	economic
տնտեսապես	-
տնտեսության	-
տնտեսությունը	-
տնօրեն	director
տնօրենների	-
տոկոս	percent
տոկոսը	-
տուգանքների	-
տուրիզմի	-
տպագրվել	-
տպավորություններ	-
տվել	-
տվեց	-
տվյալ	data
տվյալագետ	-
տվյալագետներ	-
տվյալագետների	-
տվյալագիտական	-
տվյալագիտության	-
տվյալագիտություն	-
տվյալագիտությունից	-
տվյալային	-
տվյալներ	requirement
տվյալները	-
տվյալների	-
տվյալներին	-
տվյալներն	-
տվյալներով	-
տրամաբանությամբ	-
տրամադրած	-
տրամադրել	-
տրամադրելը	-
տրամադրելով	-
տրամադրելու	-
տրամադրում	-
տրամադրվող	-
տրասնֆորմացիոն	-
ցանելու	-
ցանկանու՞մ	-
ցանկանում	-
ցանկացած	-
ցանց	network
ցանցերի	-
ցանցի	-
ցանքի	-
ցեղասպանությունը	-
ցույց	demonstration
ցուցաբերել	-
ցուցաբերում	-
ցուցադրել	show
ցուցանիշներ	-
ցուցանիշները	-
ցուցիչներ	-
ցուցիչների	-
փ	-
փախստականների	-
փաունդ	-
փառատոն	festival
փառատոնը	-
փառատոնի	-
փաստաթղթերը	-
փաստահենք	-
փաստեր	-
փաստերի	-
փարիզի	Parisian
փգհ	-
փնտրելու	-
փնտրում	-
փոխակերպող	-
փոխանակելու	-
փոխանակման	-
փոխանակումը	-
փոխանցելով	-
փոխանցելու	-
փոխանցում	passing
փոխանցումները	-
փոխանցումների	-
փոխանցվեն	-
փոխառված	-
փոխարեն	-
փոխել	change
փոխկապակցված	-
փոխկապվածությունը	-
փոխնախագահ	vicepresident
փոխվարչապետ	-
փոխվարչապետի	-
փոխտնօրեն	-
փող	money
փորձ	attempt
փորձագետ	expert
փորձագետներ	-
փորձառության	-
փորձառություն	experience
փորձարարական	tentative
փորձարարարական	-
փորձարարության	-
փորձարարություն	-
փորձարկելու	-
փորձարկման	-
փորձարկում	trial
փորձարկումը	-
փորձարկումներ	-
փորձարկումները	-
փորձարկումների	-
փորձարկումներից	-
փորձելով	-
փորձենք	-
փորձեր	-
փորձերի	-
փորձը	-
փորձի	-
փորձն	-
փորձնակ	-
փորձնական	tentative
փորձով	-
փորձում	-
փուլ	phase
փուլերի	-
փուլում	-
փոփոխելով	-
փոփոխող	-
փոփոխության	-
փոփոխությունը	-
փոփոխությունից	-
փոփոխություններ	-
փոփոխությունների	-
փոփոխվել	-
փոփոխվող	-
փոքր	small
փոքրիկ	small
փրկողների	-
ք	-
քաղաքագիտության	-
քաղաքական	political
քաղաքականության	-
քաղաքականությանը	-
քաղաքականություն	politics
քաղաքականությունը	-
քաղաքականությունից	-
քաղաքականություններ	-
քաղաքականությունները	-
քաղաքականությունների	-
քաղաքացիական	-
քաղաքացիներ	-
քաղաքացիների	-
քաղաքացիության	-
քաղաքացիություն	citizenship
քաղաքի	-
քաղցկեղը	-
քամփնի	-
քամփֆը	-
քայլեր	-
քայլերը	-
քայլը	-
քան	than
քանի	howmany
քանիսը	-
քաջատեղյակ	-
քննարկեց	-
քննարկեցինք	-
քննարկման	-
քննարկմանը	-
քննարկում	discussion
քննարկումը	-
քննարկումներ	-
քննարկումների	-
քոլեջը	-
քուին	-
քուքիներ	-
քուքիները	-
քուքիների	-
քչացնելուն	-
օբո	-
օգնական	help
օգնել	help
օգնելու	-
օգնությամբ	-
օգնում	-
օգոստոսին	-
օգտագործել	use
օգտագործելով	-
օգտագործման	-
օգտագործում	use
օգտագործումը	-
օգտագործվել	-
օգտագործվելու	-
օգտագործվում	-
օգտատերերի	-
օգտատիրոջ	-
օգտվել	avail
օգտվելով	-
օգտվելու	-
օգտվում	-
օնլայն	-
օստ	-
օստը	-
օստն	-
օր	day
օրակարգ	agenda
օրակարգի	-
օրակարգին	-
օրեգոն	oregon
օրենքի	-
օրենքները	-
օրենքների	-
օրենքներից	-
օրենքով	-
օրերին	-
օրը	-
օրինակ	example
օրինական	legal
օրինակը	-
օրվա	-
ֆ	-
ֆակուլտետը	-
ֆակուլտետից	-
ֆայլեր	-
ֆարնուորթըասաց	-
ֆերմերներ	-
ֆերմերների	-
ֆինանսական	financial
ֆինանսավորման	-
ֆինանսավորում	-
ֆինանսավորվում	-
ֆինանսների	-
ֆինլանդիայի	-
ֆրանսիական	French
ֆրանսիայի	-
և	-
ևս	-
